wwwwwwwwwwwwwwwwwwwwwwwwwwwwwwwwwwwwwwwwwwwww
wwwwwwwwwwwwwwwwwwwweeewwwwwwwwwwwwwwwwwwwwww
wwwwwwwwwwwwwwwwwwww   wwwwwwwwwwwwwwwwwwwwww
www            wwwww   wwwww              www
www             wwww   wwww               www
www              www   www                www
www               ww   ww                 www
www       wwww     w   w       wwww       www
www       wwww                 wwww       www
www       wwww                 wwww       www
www                                       www
www                wwwww                  www
www                wwwww                  www
www                wwwww                  www
www                                       www
www                                       www
www                                       www
wwwwwwwwwwwwwwwwwwwwwwwwwwwwwwwwww        www
wwwwwwwwwwwwwwwwwwwwwwwwwwwwwwwwww        www
wwwwwwwwwwwwwwwwwwwwwwwwwwwwwwwwww        www
w                                         www
w s                                       www
w                                         www
www                                       www
www                                       www
www                                       www
www                                       www
www                                       www
www                                       www
www                                       www
www                                       www
www                                       www
www                                       www
www                                       www
www                                       www
www                                       www
www                                       www
www                                       www
www                                       www
wwww                                     wwww
wwwww     w       w       w       w     wwwww
wwwwww   www     www     www     www   wwwwww
wwwwwwwwwwwwwwwwwwwwwwwwwwwwwwwwwwwwwwwwwwwww
wwwwwwwwwwwwwwwwwwwwwwwwwwwwwwwwwwwwwwwwwwwww
wwwwwwwwwwwwwwwwwwwwwwwwwwwwwwwwwwwwwwwwwwwww
