wwwwwwwwwwwwwwwwwwwwwwwwwwwwwwwwwwwwwwwwwwwww
wwwwwwwwwwwwwwwwwwwwwwwwwwwwwwwwwwwwwwwwwwwww
wwwwwwwwwwwwwwwwwwwwwwwwwwwwwwwwwwwwwwwwwwwww
www                                       www
www                                       www
www                                       www
www                                       www
www       wwww                            www
www       wwww                            www
www       wwww                            www
www                                       www
www                                       www
www                                       www
www                                       www
www                                       www
www                                       www
www                                       www
www                                       www
www                                       www
www                                       www
we                                        www
we                                        www
we                                        www
www                                       www
www                                       www
www                                       www
www                                       www
www                                       www
www                                       www
www                                       www
www                                       www
www                                       www
www                                       www
www                                       www
www                                       www
www                                       www
www                      wwwwwww          www
www                      wwwwwww          www
www                                       www
www                                       www
www              w       w                www
www             www     www               www
wwwwwwwwwwwwwwwwwwww s wwwwwwwwwwwwwwwwwwwwww
wwwwwwwwwwwwwwwwwwww   wwwwwwwwwwwwwwwwwwwwww
wwwwwwwwwwwwwwwwwwwwwwwwwwwwwwwwwwwwwwwwwwwww
