wwwwwwwwwwwwwwwwwwwwwwwwwwwwwwwwwwwwwwwwwwwww
wwwwwwwwwwwwwwwwwwww   wwwwwwwwwwwwwwwwwwwwww
wwwwwwwwwwwwwwwwwwww s wwwwwwwwwwwwwwwwwwwwww
www                                       www
www                                       www
www                                       www
www                                       www
www       wwww                            www
www       wwww                            www
www       wwww                            www
www                                       www
www                                       www
www                                       www
www                                       www
www                                       www
www                                       www
www                                       www
www                                       www
www                                       www
www                                       www
www                                       www
www                                     wwwww
www                                        ew
www                                        ew
www   e                                 wwwww
www   e                                   www
www                                       www
www                                       www
www                                       www
www                                       www
www                                       www
www                                       www
www                                       www
www                                       www
www                                       www
www                                       www
www                      wwwwwww          www
www                      wwwwwww          www
www                                       www
www                                       www
www              w       w                www
www             www     www               www
wwwwwwwwwwwwwwwwwwwwwwwwwwwwwwwwwwwwwwwwwwwww
wwwwwwwwwwwwwwwwwwwwwwwwwwwwwwwwwwwwwwwwwwwww
wwwwwwwwwwwwwwwwwwwwwwwwwwwwwwwwwwwwwwwwwwwww
