wwwwwwwwwwwwwwwwwwwwwwwwwwwwwwwwwwwwwwwwwwwww
wwwwwwwwwwwwwwwwwwwweeewwwwwwwwwwwwwwwwwwwwww
wwwwwwwwwwwwwwwwwwww   wwwwwwwwwwwwwwwwwwwwww
www                                       www
www                                       www
www  wwwwwwwwwwwwwwwwwwwwwwwwwwwwwwwwwww  www
www  wwwwwwwwwwwwwwwwwwwwwwwwwwwwwwwwwww  www
www                                       www
www                                       www
www                                       www
www                                       www
www                                       www
www                                       www
www                                       www
www                                       www
www                                       www
www                                       www
www                                       www
www                                       www
www                                       www
www                                       www
www                                       www
www                                       www
www                   w                   www
www                  www                  www
www                 wwwww                 www
www                  www                  www
www                   w                   www
www                  www                  www
www                 wwwww                 www
www                  www                  www
www                   w                   www
www                                       www
wwwwwwwwwwww                     wwwwwwwwwwww
wwwwwwwwwwwww                   wwwwwwwwwwwww
wwwwwwwwwwwwww                 wwwwwwwwwwwwww
wwwwwwwwwwwwwww               wwwwwwwwwwwwwww
wwwwwwwwwwwwwwww             wwwwwwwwwwwwwwww
wwwwwwwwwwwwwwwww           wwwwwwwwwwwwwwwww
wwwwwwwwwwwwwwwwww         wwwwwwwwwwwwwwwwww
wwwwwwwwwwwwwwwwwww       wwwwwwwwwwwwwwwwwww
wwwwwwwwwwwwwwwwwwww     wwwwwwwwwwwwwwwwwwww
wwwwwwwwwwwwwwwwwwwww s wwwwwwwwwwwwwwwwwwwww
wwwwwwwwwwwwwwwwwwwww   wwwwwwwwwwwwwwwwwwwww
wwwwwwwwwwwwwwwwwwwwwwwwwwwwwwwwwwwwwwwwwwwww
