wwwwwwwwwwwwwwwwwwwwwwwwwwwwwwwwwwwwwwwwwwwww
wwwwwwwwwwwwwwwwwwwwwwwwwwwwwwwwwwwwwwwwwwwww
wwwwwwwwwwwwwwwwwwwwwwwwwwwwwwwwwwwwwwwwwwwww
wwww w w w w w w w w w w w w w w w w w w wwww
www                                       www
www                                       www
www                           wwwwwwwwwwwwwww
www       wwww                wwwwwwwwwwwwwww
www      wwwwww                           www
www       wwww                            www
www                           wwwwwwwwwwwwwww
www                           wwwwwwwwwwwwwww
www                                       www
www                                       www
www                       wwww            www
www                      wwwwww           www
www                       wwww            www
www                                       www
www                                       www
www                                       www
we                                        www
we                                        www
we                                        www
www                                       www
www                                       www
www                                       www
www                                       www
www                       w               www
www                      www              www
www                       w               www
www                 w                     www
www                www                    www
www                 w                     www
www           w                           www
www          www                          www
www           w                           www
www     w                                 www
www    www                                www
www     w                                 www
www                                       www
www              w       w                www
wwww w w w w w wwww     wwww w w w w w w wwww
wwwwwwwwwwwwwwwwwwww s wwwwwwwwwwwwwwwwwwwwww
wwwwwwwwwwwwwwwwwwww   wwwwwwwwwwwwwwwwwwwwww
wwwwwwwwwwwwwwwwwwwwwwwwwwwwwwwwwwwwwwwwwwwww
