wwwwwwwwwwwwwwwwwwwwwwwwwwwwwwwwwwwwwwwwwwwww
wwwwwwwwwwwwwwwwwwwweeewwwwwwwwwwwwwwwwwwwwww
wwwwwwwwwwwwwwwwwwww   wwwwwwwwwwwwwwwwwwwwww
www                                       www
www                                       www
www                                       www
www                                       www
www       wwww                            www
www       wwww                            www
www       wwww                            www
www                                       www
www                                       www
www                                       www
www                                       www
www                                       www
www                                       www
www                                       www
www                                       www
www                                       www
www                                       www
w                                         www
w s                                       www
w                                         www
www                                       www
www                                       www
www                                       www
www                                       www
www                                       www
www                                       www
www                                       www
www                                       www
www                                       www
www                                       www
www                                       www
www                                       www
www                                       www
www                      wwwwwww          www
www                      wwwwwww          www
www                                       www
www                                       www
www              w       w                www
www             www     www               www
wwwwwwwwwwwwwwwwwwwwwwwwwwwwwwwwwwwwwwwwwwwww
wwwwwwwwwwwwwwwwwwwwwwwwwwwwwwwwwwwwwwwwwwwww
wwwwwwwwwwwwwwwwwwwwwwwwwwwwwwwwwwwwwwwwwwwww
